SSSSSXSSSSSS
SXXXXXSSSSSS
SXXWXXXXXXSS
SXXXXWSWSXSS
SXWXXXRXXXSS
SXXTXXSSSXSS
SXXXXXSSXTYS
SSSTSSSSSSSS