SSSSSXSSSSSS
SSSSSXXXXXTS
SSSSSSSSSSXS
SSSSXXXXTSXS
SSSSXSSSXSTS
SSSRXYSSXSXS
SSSSBSSSXXXS
SSSSSSSSSSSS
