XXXXXXXXXXXX
XXXXXXXXXXXX
XXXXXXXXXXXX
XXXXXXXXSXXX
XXXSXXXXXXXX
XXXXXXXXSXXX
XXXXXXXXXXXX
XXYSRXXXXXXX
