SSSSSXSSSSSS
SXXXXXSSSSSS
SXXXXXXXXXSS
SXXXXXSSSXSS
SXXTXXRXXXSS
SXXXXXSSSXSS
SXXXXXSSXXYS
SSSSSSSSSSSS