SSSSSXSSSSRS
SSXXXXXXXXXS
SSXSSSSSXSSS
SSXXXTSSXTXS
SSXSSSSSXSSS
SSXSSSSSXSSS
SSXSSYXXXXTS
SSSSSSSSBSSS
