SSSSSXSSSSSS
SXXXXTXXXXXS
SXSSSSSSSSXS
SXSWWWWWWSXS
STSWWWWWWSXS
RXSSBSSSSSXS
SXXXTXXXXXXS
SSSSSSYSSSXS
