SSYSSXSSSSSS
SSXSSXXXXXSS
SBXSSSSSSXSS
SSXSSSTSSXSS
SSXXSSXSSXRS
SSXSSSXSSXSS
SSTXXXXXXXSS
SSSSSSSSSTSS
