SSSSSXSSSSSS
SXXXXTXXXXXS
SXSSSSSSSSXS
SXSWWWWWWSXS
STSWWWWWWSTS
SXSSSSSSSSXS
SXXXXXXXXXXS
SRSSSSYSSSBS
