SSSSSXSSSSSS
RSXXXXXSSSXX
XXSSXXXXSXXX
XXSSXXXXSXSX
XBXXXTXSXXSY
XXXSXXXXXSXX
XSXXSXXXXXXX
XTXXXXSSXXTX
