SSSSSXSSSSSS
SXXXXXSSSSSS
SXXXXXXXXXSS
SXXXXXSSSXSS
SXXTXXRXXXSS
SXXTXXSSSXSS
SXXTXXSSXXYS
SSSSSSSSSSSS