SSXSSXSSSSBS
TXXSSXSSSSXS
SSXSWXWSSSXS
SSTSWXWSSSXY
SSTSSXSSSRXS
SSXXXXSSSXXS
SSXSSSSSXXSS
SSXXXXXXXSSS