SSSSSXSSSSSS
YSSSXXXSSSRX
XSWSXXXSWSXX
XSSSXXXSSSXX
XXXXXXXXXXXX
XSSSXXXSSSXX
XSWSXXXSWSXX
XSSSTTTSSSXB
