SSSSSXSSSSSS
SXXXXTXXXXXS
SXSSSSSSSSXS
SXSWWWWWWSXS
STSWWWWWWSXS
SXSSSSSSSSXS
SXXXTXXXXXXS
SRSSSSYSSSBS
