SSSSSXSSSSSS
SSSSSXSSSSSS
SSSSSXSSSRSS
SXXXXXXXXXYS
SSSSSXSSSBSS
SSSSSXSSSSSS
SSTTTXSSSSSS
SSSSSSSSSSSS
