SSSSSXSSSSSS
SSSSSXSSSSSS
SXXXXXXXXXSS
SSXSSSSSSXSS
SSXSSSRXXXSS
SSXXXBSSSXSS
SSXSSSSSXXYS
SSSSSSSSSSSS