SSSSSXSSSSSS
XXXTSXSXXXXR
XSSSSXSXXXXX
XXXXXXXXXXXX
XXXXSXSXXXXX
XSSSSXSXXXXX
XXXXSTSXXTXX
YXXXSXSXXXXB
