SSSWSXSWWWWW
SYSSSXSSSSSS
SXSSSXSSSSSS
SXTSSXSSSRSS
SXBSSXSSSTSS
SXSSSXSSXXSS
SXXXXXTXXSSS
SSSSSSSSSSWW
