SSSSSXSSSSSS
SXXXXTSSSSSS
SXXWXXXXXXSS
XBXXXWSWSXSS
SXWXXXRXXXSS
SXXTXXSSSXSS
SXXXXXSSXTYS
SSSXSSSSSSSS
