SSSSSXSSSSSS
SWWWSXSWWWSX
SWWWSXSWWWSX
SWSSSXSWWWSX
SSSSSXSSSSSX
SWSYTXXXXXXT
SSSSSXXSSSSX
RXXTXXXSWWSB
