SSSSSXSSSSSS
SXXXXXSSSSSS
SXXXXXXXXXSS
SXXXXXSSSXSS
SXXTXXRXXXSS
SXXTXXSSSXSS
SXXXXXSSXTYS
SSSSSSSSSSSS