SSSSSXSSSSSS
SSSSSXSSSSSS
SSSSSXSSSSYS
SSSSSXXXXXTS
SSSSSXSSSSSS
SSSSSXSSSSSS
SBXXXXXXXXRS
SSSTSSSTSSSS