SSSSSXSSSSSS
SWSXXXXXXSSS
SWSXSSTSXTSS
SWSXXSSSXSSS
SWSSXSSSXSSS
SWSXXRSXXXXY
SWSSXSSSTSSS
SSSXXSSSBSSS
