SSSSSXSSSSSS
XWWXXXXXXYXX
XXXXXXXXXWXB
WXWWXXTXXXXW
TXXXXXXXXXXX
XXWXWXXWWXWX
XXXXXXXXXXXT
RXWWXWXXWXXX
