SSSSSXSSSSSS
SSSSSXSSSTSS
SSSSSXSSSXSS
SSBSSXXTXXSS
SSXSSXSSSSSS
SSXXXXXXXXSS
SSRSSSSSSXSS
SSSSSSYXXXXT
