SSSSSXSSSSSS
SWWWSXSWWWSR
SWWWSXSWWWSX
SWWWSXSWWWSX
SSSSSXSSSSSX
SWWWSXXXXXXX
SSSSSXXSSSSX
YTXTXXXSWWSB
