SSSSSXSSSSSS
SSSSSXSSSSST
TSSSXXXSSSXX
XXSXXXXXSXXX
XXXXXXXXXXXX
XXSXXXXXSYXX
RSSSXXXSSSBX
SSSSSXSSSSST
