SSSSSXSSSSSS
SXXXSXSSSBSS
SXXXSXXXXXSS
SXXXSXSSSXSS
SXXTXXRXXXSS
SXXTXXSSSXSS
SXXXXXSSXTYS
SSSSSSSSSSSS
