SSSSSXSSSSSS
SWWWSXXXXXXX
SWWWSXXSXXSX
SWWWSXXXXSXX
SSSSSXXXSTXX
XXXXXXXXSXSX
STSTXSXXXSXX
SXSSBSSRSXSY
