SSSSSXSSSSSS
SSSTXXXXXXTS
SXXSSSSSSXSS
SSXSSSSRSXTS
SXXXXXSXSXSS
SSXSSXSXSXSS
SSYSSXXXXXSS
SSSSSSSBSSSS
