SSSSSXSSSSSS
XTXXSXSXXXXR
XXXXSXSXXXXX
XXXXXXXXXXXX
XXXXSXSXXXXX
XXXXSXSXXXXX
XTXXSXSXXTXX
YXXXSXSXXXXB
