SSSSSXSSSSSS
TSSSXXXSSSRT
XSWSXXXSWSXX
XSSSXXXSSSXX
XXXXXXXXXXXX
XSSSXXXSSSXX
XSWSXXXSWSXX
YSSSXXXSSSTB
