SSSWSXSWWWWW
SYSSSXSSWWWS
SXSSSXSSWWWS
SXTSSXSSSSSS
SXBSSXSSSTSS
SXSSSXSSXXXR
SXXXXXXXXSSS
SSXSTSSSSSWW
