SSSSSXSSSSSS
SSXSSXXXXXXX
XSSXXXXXXXXX
SSXXXXXXXXXX
XXSSXXXXXXXX
SSXXXXXXXXXX
XXSSXSSSBXYT
SSXXSSXSSRTT

