SSSSSXSSSSSS
SSXXXXXXXXSS
TSXXXXXXXXST
XXXXXXXXXXXX
XXXXXXXXXXXY
XXXXXXXXXXXX
SSSSSXSSSSSS
BXXXXTXXXXXR
