SSSSSXSSSSSS
SSSTXXXXXXTS
SRXSSSSSSXSS
SSXSSSSXSXTS
SBXXXXSXSXSS
SSXSSXSXSXSS
SSYSSXXXXXSS
SSSSSSSXSSSS
