SSSSSXSSSSSS
SSSSSXSSSSSS
SSSSXXXSSSSS
SSSXXXXXSSSS
SSXXXTXXXSSS
SXXXXXXXXXSS
TSXXXXXSXSTS
XXXRBYXSXXXX
