SSSSSXSSSSSS
SWSXXXXXXSSS
SWSXSSTSXTSS
SWSXXSSSXSSS
SWSSTSSSXSSS
SWSXXRSBXXXY
SWSSXSSSXSSS
SSSSXSSSXSSS
