SSSSSXSSSSSS
SWSXXXXXXSSS
SWSXSSTSXTSS
SWSXXSSSXSSS
SWSSTSSSXSSS
SWSXXRSBXXXS
SWSSXSSSXSSS
SSSSYSSSXSSS
