SSSSSXSSSSSS
SSSTXXXXXXTS
SSSSSSSSSXSS
SSSSSSSXSXTS
SSXXXXSXSXSS
SSYSSXSXSXRS
SSSSSXXXXXSS
SSSSSSSBSSSS
