SSSSSXSSSSSS
SXXXXXSSSTSS
SXSSSSSSSXSS
SXXXXXXXXXSS
SSSSSSSSSXSS
SSTSSSSSSXSS
SRXXXXXXXXXY
SSTSSSSSSBSS
