SSSSSXSSSSSS
SSSTXXXXXXTS
SSSSSSSSSXSS
SSRSSSSXSXTS
SBXXXXSXSXSS
SSYSSXSXSXSS
SSSSSXXXXXSS
SSSSSSSXSSSS
