SSSSSXSSSSSS
SSSSSXSSSSXS
SSSSSXSSSSXS
STXXXXXXXXTS
SSSSSXSSSSTS
SSSSSXSSYSSS
SSRXXXXXXBSS
SSSSSSSSSSSS
