SSSSSXSSSSSS
SSSSSXXXXXSS
XXXXSSSSSXSS
XSSXXXXXXXSS
XSSSSSSSSSBS
XXXSSSSSXTXR
SSXXXXXXTSXS
SSTSSSSSSSYS
