SSYSSXSSSSSS
SSXSSXXXXTSS
SBXSSSSSSXSS
SSXSSSSSSXSS
SSXRSSSSSXSS
SSXSSSSSSXSS
SSTXXXXXXTSS
SSSSSSSSSSSS
