SSSSSXSSSSSS
SSSSSXSSSSSS
SSSSSXSSSSSS
SSSSSXSWWWSS
SSSSSXSSSSSS
SSRSSXSSSSSS
SSTXXXXXXTYS
SSSTSSSSSBSS
