SSSSSXSSSSSS
SSSSSXSSSSSS
SSSSSXSSSSSS
SSSSSXSWWWSS
SSSSSXSSSSBS
SSRSSXSXXXXS
SSTXXXXXXTXS
SSSTSSSSSXYS
