SSSSSXSSSSSS
SSSSSXSSSSSS
SSSSSTSSSSSS
SSSSRXSWWWSS
SSSSSXSSSSSS
SSXSSXSSSSSS
SSXXXTXXXTYS
SSSXSSSSSBSS
