SYTSSXSSSSSS
SSXSSXSSXXXS
SSTBSXSSXWXS
SSXSSXSSXWXS
SSXSSXSSXWXS
SSXXXXXTXXXS
SSSSSSSSXSSS
WSSSSSSSRSSS
