SSSSSXSSSSSS
SSSSSXSSSSSS
SXXXXXXXXXXS
SXSSSSSSSSXS
SXSSSSSSSSXS
SXSSSSSSSSXS
SXSSSSSSSSXS
RXXXXXXXXXXR