SSSSSXSSSSSS
SSSSSXSSSSSS
SXXXXXXXXXXS
SXSSSSSSSSXS
SXSWWWWWWSXS
SXSWWWWWWSXS
SXSSSSSSSSXS
RXXXXXXXXXXR